NO ./ressources/textures/42angouleme/joy.xpm42
SO ./ressources/textures/42angouleme/analyst.xpm42  
EA ./ressources/textures/42angouleme/seekers.xpm42 		         
WE ./ressources/textures/42angouleme/architect.xpm42
	
F  252,202,96
C  108,13,171	 		 	

111111111111111111111111111111
100000000000000000000000000001
100000000111111000000000000001
100000011111111111111100000001
100000011100000000001110000001
100000011100000000000000000001
100000011100000000000000000001
100000011110000000000000000001
100000001111111111100000000001
100000000000111111111100000001
100000E00000000000011110000001
100000000000000000011110000001
100000000000000000011110000001
100000011100000000111110000001
100000011111111111111110000001
100000001111111111111100000001
100000000000000000000000000001
111111111111111111111111111111
