NO ./ressources/textures/luckyluke/brick_wall.xpm42
SO ./ressources/textures/luckyluke/joe-wanted.xpm42    
EA ./ressources/textures/luckyluke/joe_jail.xpm42 		         
WE ./ressources/textures/luckyluke/woodwall.xpm42
	
F  252,202,96
C  59,142,191		 		 	

1111111111111111111111111111
111111000001111110001111111111
111111000001111100000111111111
111111000001111100000111111111
11111100000111111101111
111111000000000000000011111111
111111000000010000000011111111
11111100000010000000001
111111000000000000000011111111
11111100N00000000000011111111
111111111111111111111111111111
