NO ./ressources/textures/savane/biche.xpm42
SO ./ressources/textures/savane/girafe.xpm42   
EA ./ressources/textures/savane/lion.xpm42    
WE ./ressources/textures/savane/suricate.xpm42
	
F  227,141,60
C  196,210,221

111111111111111111111111111111111111111111111111111111111111111111111111111111111111111
100000000001000000000000000000000000000000000001000000000000001100000000000000010000001
100000000001000000000000000001111111000000000001000000100000001000000000000000010000001
100000000001000000000010000000000000000000000001000000100000001000000000100000010000001
100000000001000000000010000000000001111100000001000000000000001000000000100000010000001
100000000001000000000010000000000000000000000001000000000000001000000000100000010000001
100000000001000000000010000000000000000000000001000000000000000000000000100000010000001
100000000001000000000010000000011111111101111101001111100000001000000000000000010000001
100000000001000000000000000000000000000100000101000000000000001000000000000000000000001
100000000001000000000000000000000000000100000001000000000000000000000000000000000000001
100000000001000000000000000000000000000100000001000000001111111111111111111111100000001
100000000001000000001111111111100010000100000001000000000000000000000000000000000000001
100000000000000000010000000000000010000100000001000000000010000000000000000000000000001
100000000000000000010000000000000010000000000001000000000010000000000111000000010000001
100000000000000000010000000000000010000000000001000000000010000000000000000000010000001
100001111111100000010000001100000010000000000000000001000010000000000000000000010000001
100000000000000000010000000000000000000000000000000001000010000000001110000000000000001
100000000000000000010000000000000000000111110000000001000010000000000000000000000000001
100000000000000000010000000000000000000000000000000001000010000000111111111110000000001
100000000000000000010000100000000000000000000011100001000010000000110000000010000000001
1000000000000000000100001000000000S0000000000000000001000000000000110000000010000000001
100000000000001111110000000000000000000000000000000001000000000000111111111110000000001
100000000000000000000000000000000000000000001110000001000000000000110000000000000000001
100000011111111000000000011111111111111000000000000000000000001000110000000000000000001
100000000000000000000000000000000000000000000000000011000000001000110000000000000000001
100000000000000000000000000000000000000000000111111111111000001000110000001111110000001
100000000000000001000000000000000111111000000000001000000000001000000000000000000000001
100000000000000000100000000000000000000000000000001000000000000000000000000000010000001
100000000000000000010000000000000000000000000000001000000000000000000000000000010000001
100000000000000000000000000000000000000001111111111000000000000010000000000000000000001
111111111111111000000000111111111100000000000000001000000000000001000000000000000000001
100000000000000000000000000000000000001000000000000000000000000000100000000001000000001
100000000000000000000000000000000000001000000000000000000000000000010000000001000000001
100000000000000000000000000000000000001000000000000000000000000000001000000001000000001
100000000000000000011111110000001000001000000000000000100000000000001000000001000000001
100000000100000000010000010000001000001000000000000000010000000000010000000001000000001
100000000100000000010000010000001000001000000000000000001000000000100000000001000000001
100000000100000000011111110000001000001000000000000000000001000100000000000001000000001
100000000100000000000000000000001000001000000000000000000000101000000000000001000000001
100000000000000000000000000000001000001000000000000000000000010000000000000000000000001
100000000000000000000000110000000000001000000011111110000000000000000000000001000000001
100000111100000000000000000000000000001000000000000000000000000000000000000001000000001
100000000000000000000000000000000000001000000000000000000000000000000000000000000000001
111111111111111111111111111111111111111111111111111111111111111111111111111111111111111
