1111111111111111111111
10000C00000001000C0001
100000000000100001C001
1000000000000000000001
1000000000000000000001
10000C000000000C000011
1000000000000000000001
100000000000C000000001
10EC0P0000000000000001
1111111111111111111111
