11111111111
10P0C0E0C11
11111111111
