NO ../../textures/capybara1.xpm42
SO ../../textures/capybara2.xpm42
WE ../../textures/capybara3.xpm42
WE ../../textures/capybara4.xpm42

F 200,100,0
C 0,0,255

 11111111
110000001
10N011111
11111
