NO ../../textures/capybara1.xpm42
SO ../../textures/capybara1.xpm42
WE ../../textures/capybara1.xpm42
EA ../../textures/capybara1.xpm42

F 200,100,0
C 0,0,255

 11101111
 10000001
10N011111
11111
