NO ../../textures/capybara1.xpm42
WE ../../textures/capybara1.xpm42
EA ../../textures/capybara1.xpm42
SO ../../textures/capybara1.xpm42

F 200,100,0
C 0,0,255

 11111111
 10000001
00N011111
11111
