NO ./ressources/textures/capybara/capybara1.xpm42
EA ./ressources/textures/capybara/capybara2.xpm42
SO ./ressources/textures/capybara/capybara3.xpm42
WE ./ressources/textures/capybara/capybara4.xpm42
	
F  59,59,59
C  22,50,85	 		 	

1111111111111111111111111111
111111000001111110001111111111
1111110000011111000001111111111
1111110000011111000001111
111111000001111111011111111
1111110000000000000000001
11111100000001000000001111111111
1111110000001000000000111101111
11111100000000000N0000000111111111111
111111000000000000000111011111100011111
111111111111111111111111111111111111111

111111111111111111111111111111111111111
1111111111100000011111110111110001101111
1111110000001111000011110111110000001111
1111110000011 110000011101111100000011111
11111100000111110000011101111100000000001
11111100000111111100011101111100000000001
11111100000000000000000001111100011100001
11111100000001000000001111111100000000001
11111100000010000000001111110000000000001
111111000000000000000011111111000000000011111111
111111000000000000000000000000000000000011111111
111111111111111111111111111111111111111111111111
1111111111111111111111111111111111111111111111111111111111111111
