1111111111111
100P000000C01
1000000000001
10000000C0001
1000011110001
10C001E010C01
1000010010001
1111111111111
